15
30
######>#######################
#..mmm....................@..#
#..m......mm.........$.......#
#..mmm..$...$..m.............#
######......m.......m.########
?????#...........*...B#???????
?????#......m.......B.#???????
?????####/#############???????
?????#........m.......#???????
?????#...m..........*.#???????
?????#########/########???????
??????????#........#??????????
??????????#..mBm...###########
??????????#......../.......*.#
??????????####>###############
15
