10
32
?###################?????#######
?#...B.............#?????#..@..#
?#.............$...#?????#.....#
##..........m......#########/###
#mm............................#
>.m.....B.......B..............#
#mm................#########/###
##............m....#?????#.mmm.#
?#....B...$........#?????#..$..#
?###################?????#######
10
